11111111111
1E000000001
10000000C01
10000000001
100C0000001
10000000001
10000000P01
10C00000001
11111111111