11111111111111111
100000000000000C1
10000000000000001
11111111111001111
10000000000000001
11001111111111111
100000000000000C1
10000000000000001
11111111111110011
10E00P00000000001
11111111111111111