111111111
1C0000011
111111111
100000E11
1C1111111
10P0000C1
111111111