111111
100C01
1E0011
0P0111
111111