111111
100C01
10E011
100P01
110111