111111111111
1C0000111C11
10000S100001
10S000C00S01
111P01111C01
100001111S11
1CS00000S0E1
111111111111