111111111
1E0000011
111111111
100000P11
1C1111111
1000000C1
111111111