1111111111111
100000C000001
1000000000001
100000C000001
1000000000001
100000E000001
1111111111111