111111111111
1111111111
111000001
1111111111
111100011
1111PCE111111
11111111111