110111
100C01
1E0011
1P0111
111111