111111111
1P0000011
111111111
100000E11
1C1111111
1000000C1
111111111