1111111111111
1000000000001
10000I0000001
10000E00000C1
1000000000001
10000000000P1
1111111111111