11111111111
10000000001
10001000001
100P0000C01
10000000001
100E0000001
10000000001
10000000C01
11111111111