11111111111111111111111111
100000000000000000000000E1
10000000000000000000000001
10000000000000000000000001
10000010001000111111000001
10000010C010000000C1000001
10000011111000111111000001
100000000010001C0000000001
10000000001000111111000001
10000000000000000000000001
10000000000000000000000001
1P000000000000000000000001
11111111111111111111111111