11111111111111
1C000000000001
11111111100111
1P000000000001
10000000000001
10000000000001
10000000000001
10000000000001
11111111111011
1EC00000000001
11111111111111