11111111111111111111111111
100000000000000C1111111111
10000000000000001111111111
11111111111001111111111111
10000000000000001111111111
11001111111111111111111111
100000000000000C1111111111
1000000C000000001111111111
11111111111001111111111111
10E00P00000000001111111111
11111111111111111111111111
11111111111111111111111111
11111111111111111111111111